#########
#-------#
#-.$.$.-#
#-.$.$.-#
#--$.$--#
#-$$.$$-#
#---@---#
#########