#####-------
#...#######-
#...------#-
#..-####$-#-
#..#####-##-
##-------#--
-#$-#$$#-###
-#--$@-#---#
-##--$-#$$-#
--##-###---#
--#-----$$-#
--#####----#
------######
